7 7
#######
#S#d  #
# ### #
# #   #
# # # #
#   #E#
#######